###################
#o.......#.......o#
#.##.##..#..##.##.#
#...............G.#
#..#...#.#..#..#..#
#..#.##..#..##.##.#
#........o........#
#..#..##.##..##...#
#.##.##..#..#..##.#
#........C........#
#..##..#...##..##.#
#..#..#..#..##.##.#
#........o........#
#..#...#.#.##...#.#
#.##.##G.#..#.#.###
#................o#
#..##..#.#.##..##.#
#G...............G#
###################