###################
#G............o..G#
#.................#
#....o............#
#.................#
#.................#
#......o..........#
#.................#
#.................#
#.................#
#.....C...........#
#.................#
#............o....#
#.................#
#.......o.........#
#.................#
#.................#
#G...............G#
###################