###################
#o.......#.......o#
#.##.##..#..##.##.#
#...............G.#
#..#...#.#..#..#..#
#.##.##..#..##.##.#
#.................#
#..#..##.##..##...#
#.##.##..#..#..##.#
#........Co.......#
#..##..#.#.##..##.#
#.##.##..#..##.##.#
#........o........#
#..##..#.#.##..##.#
#.##.##G.#..#.#.###
#................o#
#..##..#.#.##..##.#
#G...............G#
###################