#############################
#G...........#..#.....#....G#
#...#######..#..#..#..#.##..#
#......#........#..#........#
#...#..#######..#..####.#####
#...#.....#.....#...........#
#.#####..####..##.########.##
#...#..#...........#.....#..#
#...#..#..####..####..####..#
#.........#C.............#..#
#...##########..#######..#..#
#.........#...........#.....#
#...#######.##..#.###.#..####
#......#.....#..#..#..#..#..#
#.#########..#.##..#..#..#..#
#...#.....#..#..............#
#...#..#..#..####..##.#.##..#
#G.......................#.G#
#############################